00000000
00000000
00000000
00000000
00000000
00000000
00000000
21324020
44211420
41332123
13241431
41411322

00000000
00000000
00000000
00000000
00000000
00000000
00000000
02221033
03433344
14244214
42421242
31143343

00000000
00000000
00000000
00000000
00000000
00000000
00000000
30223400
20443420
32111323
12423314
14221231

00000000
00000000
00000000
00000000
00000000
00000000
00000000
02114300
02323114
21134431
21213424
23342113

00000000
00000000
00000000
00000000
00000000
00000000
00000000
10232030
33221012
24144234
11211433
43431311

00000000
00000000
00000000
00000000
00000000
00000000
00000000
30142300
40221200
41334333
34421241
14314122

00000000
00000000
00000000
00000000
00000000
00000000
00000000
11130220
32330341
14443214
12123411
44223223

00000000
00000000
00000000
00000000
00000000
00000000
00000000
20201000
30102004
21211214
41334342
24431114

00000000
00000000
00000000
00000000
00000000
00000000
00000000
03220402
02142424
32411334
41441422
44233143

00000000
00000000
00000000
00000000
00000000
00000000
00000000
21021204
42141103
33142341
31221341
14141231
